C,P,T,T,T,T,T,T
C,T,T,T,P,P,P,P
C,C,C,C,C,T,M,M
T,T,T,T,C,T,M,P
M,M,M,T,C,T,M,P
T,T,T,T,C,T,M,P
T,P,P,P,C,T,M,M
T,T,T,T,C,C,C,M